0 3 0 0 0 0 1 1 0 1
4 1 1 1 1 0 1 0 0 0
4 0 0 1 0 0 1 0 1 0
0 1 0 1 0 0 4 0 1 0
4 4 4 0 0 1 1 0 1 5
2 1 0 0 1 1 1 4 1 0
0 1 1 0 0 3 1 4 1 0
0 0 1 1 1 0 4 4 1 0
1 0 0 0 1 0 1 4 0 0
1 1 1 0 0 0 1 0 1 1
